########################
#......................#
#.###....######....###.#
#.###....######....###.#
#.###....######....###.#
#......................#
#......................#
#..........##..........#
#..........##..........#
#..........##..........#
#..........##..........#
#......................#
#......................#
#.####...######....###.#
#.####...######....###.#
#.####...######....###.#
#.####...######....###.#
#......................#
#......................#
########################